####################################
#S#  ##  ######## # #      #     # #
# #   #             # #        #   #
#   # ##### ## ###### # #######  # #
### # ##    ##      # # #     #### #
#   #    #  #######   #   ###    #E#
####################################