####################
#S                ##
################# ##
#E###              #
# ####### ### #### #
#            ##    #
### ############ ###
#                ###
####################