########S###########
##                 #
##### ########### ##
# ### #            #
# ### ### ### #### #
#         #   ##   #
### #####   #### ###
#E  ######       ###
####################