#######E####################################################
#                                                          #
##### ########### ########   #################### ##########
# ### #            ##      ##  ################## #   ######
# ### ### ### #### ## ########     ###      ##### # #     ##
#         #   ##   ## ############ ###     ######   ##### ##
### ######  #### #### ####  ###### ##### ################  #
#   ######       #                                        S#
############################################################