############################################################
#                                                          #
##### ########### ########   #################### ##########
# ### #            ##      ##  ################## #   ######
# ### ### ### #### ## ########     ###      ##### # #     ##
#         #   ##   ## ############ ###     ######   ##### ##
### #####E  #### #### ####  ###### ##### ################  #
#   ######       #                                        ##
##################################### ######################
##################################### ######################
#                                                          #
##### ########### ########   #################### ##########
# ### #            ##      ##  ################## #   ######
# ### ### ### #### ## ########     ###      ##### # #     ##
#         #   ##   ## ############ ###     ######   ##### ##
### #####   #### #### ####  ###### ##### ################  #
#   ######       #                                         #
####################### ####################################
####################### ####################################
#                                                          #
##### ########### ########   #################### ##########
# ### #            ##      ##  ################## #   ######
# ### ### ### #### ## ########     ###      ##### # #     ##
#         #   ##   ## ############ ###     ######   ##### ##
### #####   #### #### ####  ###### ##### ################  #
#   ######       #                                         #
######################################## ###################
######################################## ###################
#                                                          #
##### ########### ########   #################### ##########
# ### #            ##      ##  ################## #   ######
# ### ### ### #### ## ########     ###  S   ##### # #     ##
#         #   ##   ## ############ ###     ######   ##### ##
### #####   #### #### ####  ###### ##### ################  #
#   ######       #                                         #
############################################################